{
	"//": "This is the center part of the forest.",
    "method": "json",
    "object": {
        "fill_ter": "t_secro_flesh",
        "rows": [
            "........................................................................",
            "........................................................................",
            "........................................................................",
            "........................................................................",
            "........................................................................",
            "........................................................................",
            "........................................................................",
            "........................................................................",
            "........................................................................",
            "........................................................................",
            "........................................................................",
            "........................................................................",
            "........................................................................",
            "........................................................................",
            "........................................................................",
            "........................................................................",
            "........................................................................",
            "........................................................................",
            "........................................................................",
            "........................................................................",
            "........................................................................",
            "........................................................................",
            "........................................................................",
            "........................................................................",
            "........................................................................",
            "........................................................................",
            "...................................-....................................",
            "..................................---...................................",
            ".................................-----..................................",
            "................................-------.................................",
            "...............................---------................................",
            "..............................-----------...............................",
            ".............................-------------..............................",
            "............................---------------.............................",
            "...........................-----------------............................",
            "..........................---------0---------...........................",
            "...........................-----------------............................",
            "............................---------------.............................",
            ".............................-------------..............................",
            "..............................-----------...............................",
            "...............................---------................................",
            "................................-------.................................",
            ".................................-----..................................",
            "..................................---...................................",
            "...................................-....................................",
            "........................................................................",
            "........................................................................",
            "........................................................................",
            "........................................................................",
            "........................................................................",
            "........................................................................",
            "........................................................................",
            "........................................................................",
            "........................................................................",
            "........................................................................",
            "........................................................................",
            "........................................................................",
            "........................................................................",
            "........................................................................",
            "........................................................................",
            "........................................................................",
            "........................................................................",
            "........................................................................",
            "........................................................................",
            "........................................................................",
            "........................................................................",
            "........................................................................",
            "........................................................................",
            "........................................................................",
            "........................................................................",
            "........................................................................",
            "........................................................................"
        ],
        "terrain": {
            ".": [
                "t_secro_dirt_flesh",
                "t_secro_dirt_flesh",
                "t_secro_dirt_flesh",
                "t_secro_dirt_flesh",
                "t_secro_dirt_flesh",
                "t_secro_dirt_flesh",
                "t_secro_dirt_flesh",
                "t_secro_dirt_flesh",
                "t_secro_dirt_flesh",
                "t_secro_dirt_flesh",
                "t_secro_grass_flesh",
                "t_secro_grass_flesh",
                "t_secro_grass_flesh",
                "t_secro_grass_flesh",
                "t_secro_grass_flesh",
                "t_secro_grass_long_flesh",
                "t_secro_grass_long_flesh",
                "t_secro_grass_long_flesh",
                "t_secro_grass_tall_flesh",
                "t_secro_grass_tall_flesh",
                "t_secro_shrub_flesh",
                "t_secro_dirt_flesh",
                "t_secro_dirt_flesh",
                "t_secro_dirt_flesh",
                "t_secro_dirt_flesh",
                "t_secro_dirt_flesh",
                "t_secro_dirt_flesh",
                "t_secro_dirt_flesh",
                "t_secro_dirt_flesh",
                "t_secro_dirt_flesh",
                "t_secro_dirt_flesh",
                "t_secro_grass_flesh",
                "t_secro_grass_flesh",
                "t_secro_grass_flesh",
                "t_secro_grass_flesh",
                "t_secro_grass_flesh",
                "t_secro_grass_long_flesh",
                "t_secro_grass_long_flesh",
                "t_secro_grass_long_flesh",
                "t_secro_grass_tall_flesh",
                "t_secro_grass_tall_flesh",
                "t_secro_shrub_flesh",
                "t_secro_tree_young_flesh",
                "t_secro_dirt_flesh",
                "t_secro_dirt_flesh",
                "t_secro_dirt_flesh",
                "t_secro_dirt_flesh",
                "t_secro_dirt_flesh",
                "t_secro_dirt_flesh",
                "t_secro_dirt_flesh",
                "t_secro_dirt_flesh",
                "t_secro_dirt_flesh",
                "t_secro_dirt_flesh",
                "t_secro_grass_flesh",
                "t_secro_grass_flesh",
                "t_secro_grass_flesh",
                "t_secro_grass_flesh",
                "t_secro_grass_flesh",
                "t_secro_grass_long_flesh",
                "t_secro_grass_long_flesh",
                "t_secro_grass_long_flesh",
                "t_secro_grass_tall_flesh",
                "t_secro_grass_tall_flesh",
                "t_secro_shrub_flesh",
                "t_secro_dirt_flesh",
                "t_secro_dirt_flesh",
                "t_secro_dirt_flesh",
                "t_secro_dirt_flesh",
                "t_secro_dirt_flesh",
                "t_secro_dirt_flesh",
                "t_secro_dirt_flesh",
                "t_secro_dirt_flesh",
                "t_secro_dirt_flesh",
                "t_secro_dirt_flesh",
                "t_secro_grass_flesh",
                "t_secro_grass_flesh",
                "t_secro_grass_flesh",
                "t_secro_grass_flesh",
                "t_secro_grass_flesh",
                "t_secro_grass_long_flesh",
                "t_secro_grass_long_flesh",
                "t_secro_grass_long_flesh",
                "t_secro_grass_tall_flesh",
                "t_secro_grass_tall_flesh",
                "t_secro_shrub_flesh",
                "t_secro_tree_young_flesh",
				"t_secro_dirt_flesh",
                "t_secro_dirt_flesh",
                "t_secro_dirt_flesh",
                "t_secro_dirt_flesh",
                "t_secro_dirt_flesh",
                "t_secro_dirt_flesh",
                "t_secro_dirt_flesh",
                "t_secro_dirt_flesh",
                "t_secro_dirt_flesh",
                "t_secro_dirt_flesh",
                "t_secro_grass_flesh",
                "t_secro_grass_flesh",
                "t_secro_grass_flesh",
                "t_secro_grass_flesh",
                "t_secro_grass_flesh",
                "t_secro_grass_long_flesh",
                "t_secro_grass_long_flesh",
                "t_secro_grass_long_flesh",
                "t_secro_grass_tall_flesh",
                "t_secro_grass_tall_flesh",
                "t_secro_shrub_flesh",
                "t_secro_dirt_flesh",
                "t_secro_dirt_flesh",
                "t_secro_dirt_flesh",
                "t_secro_dirt_flesh",
                "t_secro_dirt_flesh",
                "t_secro_dirt_flesh",
                "t_secro_dirt_flesh",
                "t_secro_dirt_flesh",
                "t_secro_dirt_flesh",
                "t_secro_dirt_flesh",
                "t_secro_grass_flesh",
                "t_secro_grass_flesh",
                "t_secro_grass_flesh",
                "t_secro_grass_flesh",
                "t_secro_grass_flesh",
                "t_secro_grass_long_flesh",
                "t_secro_grass_long_flesh",
                "t_secro_grass_long_flesh",
                "t_secro_grass_tall_flesh",
                "t_secro_grass_tall_flesh",
                "t_secro_shrub_flesh",
                "t_secro_tree_young_flesh",
                "t_secro_dirt_flesh",
                "t_secro_dirt_flesh",
                "t_secro_dirt_flesh",
                "t_secro_dirt_flesh",
                "t_secro_dirt_flesh",
                "t_secro_dirt_flesh",
                "t_secro_dirt_flesh",
                "t_secro_dirt_flesh",
                "t_secro_dirt_flesh",
                "t_secro_dirt_flesh",
                "t_secro_grass_flesh",
                "t_secro_grass_flesh",
                "t_secro_grass_flesh",
                "t_secro_grass_flesh",
                "t_secro_grass_flesh",
                "t_secro_grass_long_flesh",
                "t_secro_grass_long_flesh",
                "t_secro_grass_long_flesh",
                "t_secro_grass_tall_flesh",
                "t_secro_grass_tall_flesh",
                "t_secro_shrub_flesh",
                "t_secro_dirt_flesh",
                "t_secro_dirt_flesh",
                "t_secro_dirt_flesh",
                "t_secro_dirt_flesh",
                "t_secro_dirt_flesh",
                "t_secro_dirt_flesh",
                "t_secro_dirt_flesh",
                "t_secro_dirt_flesh",
                "t_secro_dirt_flesh",
                "t_secro_dirt_flesh",
                "t_secro_grass_flesh",
                "t_secro_grass_flesh",
                "t_secro_grass_flesh",
                "t_secro_grass_flesh",
                "t_secro_grass_flesh",
                "t_secro_grass_long_flesh",
                "t_secro_grass_long_flesh",
                "t_secro_grass_long_flesh",
                "t_secro_grass_tall_flesh",
                "t_secro_grass_tall_flesh",
                "t_secro_shrub_flesh",
                "t_secro_tree_young_flesh",
                "t_secro_tree_flesh"
            ]
        },
        "furniture": {
            ".": [
                "f_null",
                "f_null",
                "f_null",
                "f_null",
                "f_null",
                "f_null",
                "f_null",
                "f_null",
                "f_null",
                "f_null",
				"f_null",
                "f_null",
                "f_null",
                "f_null",
                "f_null",
                "f_null",
                "f_null",
                "f_null",
                "f_null",
                "f_null",
				"f_null",
                "f_null",
                "f_null",
                "f_null",
                "f_null",
                "f_null",
                "f_null",
                "f_null",
                "f_null",
                "f_null",
				"f_null",
                "f_null",
                "f_null",
                "f_null",
                "f_null",
                "f_null",
                "f_null",
                "f_null",
                "f_null",
                "f_null",
                "f_secro_flower_flesh",
                "f_secro_flower_flesh",
				"f_null",
                "f_null",
                "f_null",
                "f_null",
                "f_null",
                "f_null",
                "f_null",
                "f_null",
                "f_null",
                "f_null",
                "f_null",
                "f_null",
                "f_null",
                "f_null",
                "f_null",
                "f_null",
                "f_null",
                "f_null",
                "f_null",
                "f_null",
				"f_null",
                "f_null",
                "f_null",
                "f_null",
                "f_null",
                "f_null",
                "f_null",
                "f_null",
                "f_null",
                "f_null",
				"f_null",
                "f_null",
                "f_null",
                "f_null",
                "f_null",
                "f_null",
                "f_null",
                "f_null",
                "f_null",
                "f_null",
                "f_secro_flower_flesh",
                "f_secro_flower_flesh",
				"f_null",
                "f_null",
                "f_null",
                "f_null",
                "f_null",
                "f_null",
                "f_null",
                "f_null",
                "f_null",
                "f_null",
				"f_null",
                "f_null",
                "f_null",
                "f_null",
                "f_null",
                "f_null",
                "f_null",
                "f_null",
                "f_null",
                "f_null",
				"f_null",
                "f_null",
                "f_null",
                "f_null",
                "f_null",
                "f_null",
                "f_null",
                "f_null",
                "f_null",
                "f_null",
				"f_null",
                "f_null",
                "f_null",
                "f_null",
                "f_null",
                "f_null",
                "f_null",
                "f_null",
                "f_null",
                "f_null",
                "f_secro_boulder_small_flesh",
                "f_secro_boulder_medium_flesh",
                "f_null",
                "f_null",
                "f_null",
                "f_null",
                "f_null",
                "f_null",
                "f_null",
                "f_null",
                "f_null",
                "f_null",
				"f_null",
                "f_null",
                "f_null",
                "f_null",
                "f_null",
                "f_null",
                "f_null",
                "f_null",
                "f_null",
                "f_null",
				"f_null",
                "f_null",
                "f_null",
                "f_null",
                "f_null",
                "f_null",
                "f_null",
                "f_null",
                "f_null",
                "f_null",
				"f_null",
                "f_null",
                "f_null",
                "f_null",
                "f_null",
                "f_null",
                "f_null",
                "f_null",
                "f_null",
                "f_null",
                "f_secro_flower_flesh",
                "f_secro_flower_flesh",
				"f_null",
                "f_null",
                "f_null",
                "f_null",
                "f_null",
                "f_null",
                "f_null",
                "f_null",
                "f_null",
                "f_null",
                "f_null",
                "f_null",
                "f_null",
                "f_null",
                "f_null",
                "f_null",
                "f_null",
                "f_null",
                "f_null",
                "f_null",
				"f_null",
                "f_null",
                "f_null",
                "f_null",
                "f_null",
                "f_null",
                "f_null",
                "f_null",
                "f_null",
                "f_null",
				"f_null",
                "f_null",
                "f_null",
                "f_null",
                "f_null",
                "f_null",
                "f_null",
                "f_null",
                "f_null",
                "f_null",
                "f_secro_flower_flesh",
                "f_secro_flower_flesh",
				"f_null",
                "f_null",
                "f_null",
                "f_null",
                "f_null",
                "f_null",
                "f_null",
                "f_null",
                "f_null",
                "f_null",
				"f_null",
                "f_null",
                "f_null",
                "f_null",
                "f_null",
                "f_null",
                "f_null",
                "f_null",
                "f_null",
                "f_null",
				"f_null",
                "f_null",
                "f_null",
                "f_null",
                "f_null",
                "f_null",
                "f_null",
                "f_null",
                "f_null",
                "f_null",
				"f_null",
                "f_null",
                "f_null",
                "f_null",
                "f_null",
                "f_null",
                "f_null",
                "f_null",
                "f_null",
                "f_null",
                "f_secro_boulder_small_flesh",
                "f_secro_boulder_medium_flesh",
				"f_null",
                "f_null",
                "f_null",
                "f_null",
                "f_null",
                "f_null",
                "f_null",
                "f_null",
                "f_null",
                "f_null",
				"f_null",
                "f_null",
                "f_null",
                "f_null",
                "f_null",
                "f_null",
                "f_null",
                "f_null",
                "f_null",
                "f_null",
				"f_null",
                "f_null",
                "f_null",
                "f_null",
                "f_null",
                "f_null",
                "f_null",
                "f_null",
                "f_null",
                "f_null",
				"f_null",
                "f_null",
                "f_null",
                "f_null",
                "f_null",
                "f_null",
                "f_null",
                "f_null",
                "f_null",
                "f_null",
                "f_secro_boulder_large_flesh",
				"f_null",
                "f_null",
                "f_null",
                "f_null",
                "f_null",
                "f_null",
                "f_null",
                "f_null",
                "f_null",
                "f_null",
				"f_null",
                "f_null",
                "f_null",
                "f_null",
                "f_null",
                "f_null",
                "f_null",
                "f_null",
                "f_null",
                "f_null",
				"f_null",
                "f_null",
                "f_null",
                "f_null",
                "f_null",
                "f_null",
                "f_null",
                "f_null",
                "f_null",
                "f_null",
				"f_null",
                "f_null",
                "f_null",
                "f_null",
                "f_null",
                "f_null",
                "f_null",
                "f_null",
                "f_null",
                "f_null",
				"f_null",
                "f_null",
                "f_null",
                "f_null",
                "f_null",
                "f_null",
                "f_null",
                "f_null",
                "f_null",
                "f_null",
				"f_null",
                "f_null",
                "f_null",
                "f_null",
                "f_null",
                "f_null",
                "f_null",
                "f_null",
                "f_null",
                "f_null",
				"f_null",
                "f_null",
                "f_null",
                "f_null",
                "f_null",
                "f_null",
                "f_null",
                "f_null",
                "f_null",
                "f_null",
				"f_null",
                "f_null",
                "f_null",
                "f_null",
                "f_null",
                "f_null",
                "f_null",
                "f_null",
                "f_null",
                "f_null"
            ],
            "-": [
                "f_null",
                "f_null",
                "f_null",
                "f_null",
                "f_null",
                "f_null",
                "f_null",
                "f_null",
                "f_null",
                "f_null",
				"f_null",
                "f_null",
                "f_null",
                "f_null",
                "f_null",
                "f_null",
                "f_null",
                "f_null",
                "f_null",
                "f_null",
                "f_secro_tree_flesh_atk",
                "f_null",
                "f_null",
                "f_null",
                "f_null",
                "f_null",
                "f_null",
                "f_null",
                "f_null",
                "f_null",
                "f_null",
				"f_null",
                "f_null",
                "f_null",
                "f_null",
                "f_null",
                "f_null",
                "f_null",
                "f_null",
                "f_null",
                "f_null",
                "f_secro_tree_flesh_atk",
				"f_null",
                "f_null",
                "f_null",
                "f_null",
                "f_null",
                "f_null",
                "f_null",
                "f_null",
                "f_null",
                "f_null",
				"f_null",
                "f_null",
                "f_null",
                "f_null",
                "f_null",
                "f_null",
                "f_null",
                "f_null",
                "f_null",
                "f_null",
                "f_secro_flesh_tendril_spawner",
                "f_secro_flesh_biter_spawner"
            ]
        }
    },
    "om_terrain": [
        ["flesh_forest_3", "flesh_forest_2", "flesh_forest_1"],
        ["flesh_forest_6", "flesh_forest_5", "flesh_forest_4"],
        ["flesh_forest_9", "flesh_forest_8", "flesh_forest_7"]
    ],
    "type": "mapgen",
    "weight": 1000
}
