[
 {
    "method": "json",
    "object": {
		"fill_ter": "t_grass",
        "rows": [
        "                        ",
        "                        ",
        "                        ",
        "                        ",
        "                        ",
        "                        ",
        "             .          ",
        "       ... .,..         ",
        "      ./,,....,.        ",
        "      .,>//,,.,.        ",
        "       ./,,,,,,,.       ",
        "        ..,,//,,,.      ",
        "          .,,/,,,...    ",
        "        ..,,///,,,..    ",
        "      ..,,,/////,,,.    ",
        "         .,///////,,..  ",
        "       ..,,//////,,     ",
        "      ..,,,/////,,..    ",
        "     ..,,,,,//,,,.      ",
        "       .,,/////,,,,..   ",
        "      .,,,,,,,,,,./,.   ",
        "        .,,,.....,..    ",
        "          ....   ..     ",
        "                        "
        ],
        "terrain": {
			" ": ["t_dirt", "t_grass"],
            ".": ["t_dirt_fleshy", "t_dirt"],
            ",": ["t_grass_fleshy", "t_dirt_fleshy", "t_dirt"],
            "/": ["t_grass_long_fleshy", "t_grass_fleshy", "t_dirt_fleshy"],
			"|": ["t_hole_down_fleshy", "t_grass_long_secret_fleshy"],
			">": "t_hole_down_fleshy"
        }
    },
    "om_terrain": "Secroflesh_top",
    "type": "mapgen",
    "weight": 300
 },
 {
    "method": "json",
    "object": {
		"fill_ter": "t_wall_fleshy",
        "rows": [
			"########################",
            "########################",
            "########################",
            "########################",
            "########################",
            "############,,,,########",
            "###########,,//,,#######",
            "############,,]/,,######",
            "##########,,]//,,#######",
            "########<#,,//],,#######",
            "########,/]///,,########",
            "######,,////,,##########",
            "########,,/]/,,#########",
            "########,,/,,###########",
            "########,,//,,##########",
            "#########,,/////,,######",
            "####,,/////]///,,#######",
            "#,,///]/,,,/,,,,,#######",
            "##,,///,,,,,,#,,,#######",
            "####,,]//,]//,,#########",
            "######,,/////],,########",
            "#########,,/////,,######",
            "##########,,///////,,###",
            "#########,,]]///,,######"
        ],
        "terrain": {
            "#": "t_wall_fleshy",
            ",": ["t_wall_fleshy", "t_floor_fleshy"],
            "/": "t_floor_fleshy",
			"]": "t_floor_fleshy",
			"<": "t_hole_up_fleshy"
        },
		"place_monsters": [ { "monster": "GROUP_FCAVERN_B1", "x": [ 2, 22 ], "y": [ 2, 22 ], "repeat": [ 1, 2 ], "density": 0.1 } ]
    },
    "om_terrain": "Secroflesh_b1_north",
    "type": "mapgen",
    "weight": 300
 },
 {
    "method": "json",
    "object": {
		"fill_ter": "t_wall_fleshy",
        "rows": [
			"########################",
            "########################",
            "########################",
            "########################",
            "########################",
            "############,,,,########",
            "###########,,//,,#######",
            "############,,//,,######",
            "##########,,/]/,/#######",
            "########<#,,//],/#######",
            "########,//]//,,/#######",
            "######,,,,,,,,##,/######",
            "########,,,,,,,##]/#,###",
            "########,,,,,,##/,#/,,##",
            "########,,,,,,,#/,#,,,,#",
            "#########,,,,,,,,/#,,###",
            "####,,//]//////,/#######",
            "#,,/##//,,,/,,,/,#######",
            "##,,/#/,,,,,,#,,,#######",
            "####,,]//,//],,#########",
            "######,,///]//,,########",
            "#########,,////],,######",
            "##########,,///////,,###",
            "#########,,//]//,,######"
        ],
        "terrain": {
            "#": "t_wall_fleshy",
            ",": ["t_wall_fleshy", "t_floor_fleshy"],
            "/": "t_floor_fleshy",
			"]": "t_floor_fleshy",
			"<": "t_hole_up_fleshy"
        },
		"place_monsters": [ { "monster": "GROUP_FCAVERN_B1", "x": [ 2, 22 ], "y": [ 2, 22 ], "repeat": [ 1, 2 ], "density": 0.1 } ]
    },
    "om_terrain": "Secroflesh_b1_north",
    "type": "mapgen",
    "weight": 300
 },
 {
    "method": "json",
    "object": {
		"fill_ter": "t_wall_fleshy",
        "rows": [
			"#####,,//],,////,,######",
            "######,,///////,,#######",
            "####,,////,,/////,,#####",
            "##,,/////###/,//]///,,##",
            "###,,//]/#/####,///,,###",
            "####,,/,//#####///],,###",
            "####,,//,//##,#,/////,,#",
            "#####,,/#,////###,////,#",
            "#####,,///]//#####//,,##",
            "#######,,/////,///],,###",
            "########,,////,,//,,####",
            "##########,,/////////,,#",
            "#######,,//##,,/]/////,#",
            "######,,/####,#//////,##",
            "#,,////]//##/#/##]//,###",
            "####,,//,///#,###//,,###",
            "####,,///,/##/#/]/,,####",
            "######,,/,/,##/#//,,####",
            "#####,,///]///##//],,###",
            "###############//,,#####",
            "############,/#//#######",
            "##############/]#/,#####",
            "#########,,//]//########",
            "##########,,/,/,,#######"
        ],
        "terrain": {
            "#": "t_wall_fleshy",
            ",": ["t_wall_fleshy", "t_floor_fleshy"],
            "/": "t_floor_fleshy",
			"]": "t_floor_fleshy"
        },
		"place_monsters": [ { "monster": "GROUP_FCAVERN_B1", "x": [ 2, 22 ], "y": [ 2, 22 ], "repeat": [ 1, 2 ], "density": 0.1 } ]
    },
    "om_terrain": "Secroflesh_b1_center",
	"//": "Concentrated area.",
    "type": "mapgen",
    "weight": 300
 },
 {
    "method": "json",
    "object": {
		"fill_ter": "t_wall_fleshy",
        "rows": [
			"#####,,///,,////,,######",
            "######,,]//////,,#######",
            "####,,////,,/]///,,#####",
            "##,,,,,,,,///,,,,,,,,,##",
            "###,,,,,//],,/,,,,,,,###",
            "####,,,,,,/,//,,,,,,,###",
            "####,,,,,,,/]////,,,,,,#",
            "#####,,,,,////,,,,,,,,,#",
            "#####,,///,,/,,,,,//,,##",
            "####,,/,,//]//,////,,###",
            "###,,/,,,,////,,]/,,####",
            "###,,/######//////,,,,,#",
            "##,,/##,,,,##,,//,,,//,#",
            "##,/##,,/,,,#/,//,,//,##",
            "#,,///////,,/,/,,,//,###",
            "####,,]/,///,,,,,/],,###",
            "####,,///,/,//////,,####",
            "######,,/,/,,/,,//,,####",
            "#####,,/////],,,//],,###",
            "#####,,//####,,//,,,####",
            "#####,,/####,,,//,,#####",
            "####,,/,#//,,,//,,,#####",
            "#####,,//,,///]/,,######",
            "#########,,,/,/,,#######"
        ],
        "terrain": {
            "#": "t_wall_fleshy",
            ",": ["t_wall_fleshy", "t_floor_fleshy"],
            "/": "t_floor_fleshy",
			"]": "t_floor_fleshy"
        },
		"place_monsters": [ { "monster": "GROUP_FCAVERN_B1", "x": [ 2, 22 ], "y": [ 2, 22 ], "repeat": [ 1, 2 ], "density": 0.1 } ]
    },
    "om_terrain": "Secroflesh_b1_center",
	"//": "Even more randomized and concentrated area.",
    "type": "mapgen",
    "weight": 300
 },
 {
    "method": "json",
    "object": {
		"fill_ter": "t_wall_fleshy",
        "rows": [
			"########,,,,]///,,######",
            "#######,,////]#####//###",
            "######,,/#]/###|,#/##/##",
            "#######,,//,#,###/#,##|#",
            "######,,//,,##/////#/###",
            "####,,/]/,,##,##]/##|###",
            "######,,//,#|#///]/#####",
            "###,,////####/,/////####",
            "##/##,//##,,////,#////##",
            "###/,]/,#,,#,,///##,///#",
            "#,////,######,#///#//,,#",
            "##,,//,#,,,,##////#///,#",
            "#,,//,##,,/##/#,#////,##",
            "##,,//#,/]//###/////,###",
            "##,,],#//##]//#,#]///,##",
            "#,,///##//##/]##//]/,,##",
            "##,,///#///##//##//,,###",
            "####,,/]/,,###////,,####",
            "#####,,,,,##//#//,,#####",
            "###########,,,#,,#######",
            "########################",
            "########################",
            "########################",
            "########################"
        ],
        "terrain": {
            "#": "t_wall_fleshy",
            ",": ["t_wall_fleshy", "t_floor_fleshy"],
            "/": "t_floor_fleshy",
			"]": "t_floor_fleshy",
			"|": "t_hole_down_fleshy"
        },
		"place_monsters": [ { "monster": "GROUP_FCAVERN_B1", "x": [ 2, 22 ], "y": [ 2, 22 ], "repeat": [ 1, 2 ], "density": 0.1 } ]
    },
    "om_terrain": "Secroflesh_b1_south",
    "type": "mapgen",
    "weight": 300
 }
]